type octile
height 14
width 20
map
@@......@@@@......@@
@@......@@@@......@@
@@......@@@@......@@
@@......@@@@......@@
@@......@@@@......@@
@@......@@@@......@@
@@......@@@@......@@
@@......@@@@......@@
....................
....................
.........@@.........
....................
@@................@@
@@................@@
